5 7 4
1 2 6 7
1 5 6 7
0 0 0 0 0 0 0
1 1 1 1 1 0 1
1 1 1 0 0 0 0
0 0 0 0 0 0 0
0 0 1 1 0 0 0